🚛 🥇 0️⃣ ✋ 📥 🥇
🚛 🥇 3️⃣ 3️⃣ ✋ 📥 🥇
🚛 🥇 1️⃣ 0️⃣ 0️⃣ ✋ 📥 🥇
🚛 🥇 1️⃣ 0️⃣ 8️⃣ ✋ 📥 🥇
🚛 🥇 1️⃣ 1️⃣ 4️⃣ ✋ 📥 🥇
🚛 🥇 1️⃣ 1️⃣ 1️⃣ ✋ 📥 🥇
🚛 🥇 1️⃣ 1️⃣ 9️⃣ ✋ 📥 🥇
🚛 🥇 3️⃣ 2️⃣ ✋ 📥 🥇
🚛 🥇 4️⃣ 4️⃣ ✋ 📥 🥇
🚛 🥇 1️⃣ 1️⃣ 1️⃣ ✋ 📥 🥇
🚛 🥇 1️⃣ 0️⃣ 8️⃣ ✋ 📥 🥇
🚛 🥇 1️⃣ 0️⃣ 8️⃣ ✋ 📥 🥇
🚛 🥇 1️⃣ 0️⃣ 1️⃣ ✋ 📥 🥇
🚛 🥇 7️⃣ 2️⃣ ✋ 📥 🥇


🖋💠🔶🎌🚩🏁 
🎤
😄 🏀 💰💠🔶🎌🚩🏁 😐
⌛
